B U B U U U U U U U U U U U U B
R R R R U U U U U U U U U U U R
. R R R R U U U B U U U U U B R
B R R R R U U U . R U U U U U R
. U R R R . U U U B . U U B R R
. U U R R . U U B R U U U R R R
R U U U R . U B U B . U U U R R
R . U U U R B U R . U U U U R R
R R U U U B R . R U U U U U U R
R . U U B R . U U R U U U U B R
. U U B R R . U U U U R U U R R
. U B R R R U U U U U U U U U R
. B R R R R . U U U U U U U B R
R R R R R . U U U U U U U U U R
R R R R . U U U U U U U U U U R
. R R . U U U U U U U U U U U R